V V V V V V V V V V V V V V V V V V V V
0 0 0 0 S 0 0 0 0 0 0 0 0 0 0 0 0 0 0 0
0 0 0 0 o 0 0 0 0 0 0 0 0 0 0 0 0 0 0 0
0 0 0 0 o 0 0 0 0 0 0 o o o o o o o 0 0
0 0 o o o 0 0 0 o o o o 0 0 0 0 0 o 0 0
0 0 o 0 0 0 0 o o 0 0 0 0 0 0 0 0 o 0 0
0 0 o o 0 0 0 o 0 0 0 0 0 0 0 0 0 o 0 0 
0 0 0 o 0 0 0 o 0 0 0 0 0 o o o o o 0 0
0 0 0 o 0 o o o 0 0 0 0 0 o 0 0 0 0 0 0
0 0 0 o 0 o 0 0 0 o o o o o 0 0 0 0 0 0
0 0 0 o 0 o 0 0 0 o 0 0 0 0 0 0 0 0 0 0
0 0 0 o 0 o 0 0 0 o 0 0 0 0 0 0 0 0 0 0
0 0 0 o 0 o 0 0 0 o o o o o o o 0 0 0 0
0 0 0 o o o 0 0 0 0 0 0 0 0 0 o 0 0 0 0
0 0 0 0 0 0 0 0 0 0 0 0 0 0 0 o 0 0 0 0
0 0 0 0 0 0 0 0 0 0 0 0 0 0 0 B 0 0 0 0

