9 9 9 9 9 9 9 9 9 9 9 9 9 9 9 9 9 9 9 9
0 0 0 0 4 0 0 0 0 0 0 0 0 0 0 0 0 0 0 0
0 0 0 0 3 0 0 0 0 0 0 0 0 0 0 0 0 0 0 0
0 0 0 0 3 0 0 0 0 0 0 3 3 3 3 3 3 3 0 0
0 0 3 3 3 0 0 0 3 3 3 3 1 0 0 0 0 3 0 0
0 0 3 0 0 0 0 3 3 1 1 1 1 1 0 0 0 3 0 0
0 0 3 3 0 0 0 3 0 1 1 1 2 1 1 0 0 3 0 0 
0 0 0 3 0 0 0 3 0 1 1 1 1 3 3 3 3 3 0 0
0 0 0 3 0 3 3 3 1 2 1 1 1 3 0 0 0 0 0 0
0 0 0 3 0 3 0 0 1 3 3 3 3 3 0 0 0 0 0 0
0 0 0 3 0 3 0 0 0 3 0 0 0 0 0 0 0 0 0 0
0 0 0 3 0 3 0 0 0 3 0 0 0 0 0 0 0 0 0 0
0 0 0 3 0 3 0 0 0 3 3 3 3 3 3 3 0 0 0 0
0 0 0 3 3 3 0 1 0 0 0 0 0 0 0 3 0 0 0 0
0 0 0 0 0 0 1 1 1 0 0 0 0 0 0 3 0 0 0 0
0 0 0 0 0 1 1 1 1 1 0 0 0 0 0 5 0 0 0 0
